96,96,96,96,96,96,96,96,98,99,96,96,96,96,96,96,96,96,96,96,96,96,98,99,96,96,96,96,96,96,96,96
96,96,96,96,96,96,96,96,103,104,3,3,3,3,3,3,3,3,3,3,3,3,103,104,96,96,96,96,96,96,96,96
96,96,96,96,96,96,96,96,3,3,3,3,3,3,3,3,3,3,3,3,3,3,3,3,96,96,96,96,96,96,96,96
96,96,96,96,96,96,96,96,3,3,3,3,3,3,3,3,3,3,3,3,3,3,3,3,96,96,96,96,96,96,96,96
96,96,96,96,96,96,96,96,3,3,3,3,3,3,3,3,3,3,3,3,3,96,96,96,96,96,96,96,96,96,96,96
96,96,96,96,96,96,96,96,3,3,3,3,3,3,3,3,3,3,3,3,96,96,96,96,96,96,96,96,96,96,96,96
96,96,96,96,96,96,96,96,3,3,3,3,3,3,3,3,3,3,3,96,96,96,96,96,96,96,96,96,96,96,96,96
96,96,96,96,96,96,96,96,3,3,3,3,3,3,3,3,3,3,96,96,96,96,96,96,96,96,96,96,96,96,96,96
96,96,96,96,96,96,96,96,3,3,3,3,3,3,3,3,3,96,96,96,96,96,96,96,96,96,96,96,96,96,96,96
96,96,96,96,96,96,96,96,3,3,3,3,3,3,3,3,96,96,96,96,96,96,96,96,96,96,96,96,96,96,96,96
96,96,96,96,96,96,96,96,96,96,96,96,96,96,96,96,96,96,96,96,96,96,96,96,96,96,96,96,96,96,96,96
96,96,96,96,96,96,96,96,96,96,96,96,96,96,96,96,96,96,96,96,96,96,96,96,96,96,96,96,96,96,96,96
